BARGE	Paul
BARLET	Noé
BAUM	Matthieu
BILLIARD	Mathis
BOCHU	Axel
BURIEZ	Auguste
CACHEUX	Nolan
CHAFAI	Djallal Mehdi
CHIADMI	Yassine
COCCA	Florian
CREPIN	Gaspard
DAILLY	Paul
DANEL	Théo
DE ALMEIDA	Julien
DEBERDT	Alexandre
DEGRAEVE	Rémi
DELEPLANQUE	Audren
DELERUE	Paul
DELOBEL	Hadrien
DENIS	Guillaume
DEPARIS	Hippolyte
DE POORTER	Maxence
DESPLANQUES	Esteban
DESWARTE	Wilfried
DIREZ	Antoine
EL BAKALI	Amine
ESPRIET	Charles
EUDELINE	Nathan
EVAIN	Sacha
FACON-BOCQUET	Alexandre
FICHEUX	Rémy
HAGE	Rémi
HELLEBOID	Hugo
HOSTE	Matthieu
HUBERT	Benjamin
KELMA	Cyprien
LACROIX	Matthieu
LALLART	Anya
LAMBERT	Edouard
LANGER	Camille
LEMICHEL	Thibaut
LEROUX	Enzo
LIBERT	Baptiste
LONGATTE	Marc-Antoine
LORIDAN	Juliane
MAERTE	Alixe
MANY	Hugo
MARIE	Xavier
MATHON	Mathys
MAZAINGUE	Paul
MAZOUNI	Anaëlle
MERLAUD	Thomas
MILLOGO	Uriel Arthur
MONTUORI	Milo
PAPEGHIN	Olivier
PERES	Eliott
PIETRI	Romain
PORET	Lucas
POUSSET	Paul
POUTRAIN	Martin
RAOUMBE	Axel
REYNAUD	Julien
RICHARD	Antoine
ROSIER	Enzo
RUDANT	Louis
SAUNIER	Hugo
SERGIANI	Enzo
SOKOLOWSKI	Raphaël
SOULAS	Benjamin
STORDEUR	Théo
TICHAND	Léo
TONNERRE	Cyriaque
VANDOOLAEGHE	Roméo
VANGHELUWE	Théo
VERHAEGHE	Adrien
VICO	Isaure
VIDAL	Adam
VITSE	Hugo
ZHENG	Estelle